R 700 700
NO         ./textures/walls/wall1.xpm
     SO ./textures/walls/wall1.xpm

   F ./textures/walls/stone1.xpm


C ./textures/walls/stone1.xpm

WE ./textures/walls/wall1.xpm

EA ./textures/walls/wall1.xpm
S ./textures/sprites/barrel.xpm

D ./textures/walls/wood.xpm


        1111111111111111111111111
        1000000000110000000000001
        1011000001110002000000001
        1001000000000002200000001
111111111011000001110000200000001
100000000011000001110111100111111
11110111111111011100000010001
11110111111111011101010010001
11000000110101011100000012021
10000000000000001100000010001
10000000000000001101010010001
11000001110101011111011110N0111
11110111 1110101 101111010001
11111111 1111111 111111111111
